b'B'b'B'b'B'b'B'b'B'b'B'b'B'b'B'b'B'b'B'b'B'b'B'b'B'b'B'b'B'b'B'b'B'
b'B'b'F'b'G'b'M'b'M'b'G'b'F'b'G'b'G'b'G'b'F'b'M'b'M'b'F'b'M'b'M'b'B'
b'B'b'F'b'F'b'F'b'G'b'M'b'F'b'G'b'W'b'G'b'M'b'F'b'F'b'M'b'M'b'F'b'B'
b'B'b'M'b'F'b'G'b'G'b'F'b'M'b'G'b'W'b'G'b'F'b'G'b'F'b'F'b'M'b'M'b'B'
b'B'b'M'b'M'b'F'b'M'b'F'b'F'b'G'b'G'b'G'b'M'b'G'b'M'b'F'b'M'b'F'b'B'
b'B'b'G'b'G'b'G'b'G'b'G'b'F'b'G'b'M'b'G'b'G'b'F'b'G'b'M'b'G'b'F'b'B'
b'B'b'M'b'G'b'F'b'F'b'D'b'F'b'M'b'F'b'F'b'G'b'G'b'F'b'F'b'F'b'M'b'B'
b'B'b'G'b'F'b'G'b'F'b'M'b'M'b'M'b'M'b'F'b'G'b'F'b'M'b'M'b'F'b'M'b'B'
b'B'b'F'b'M'b'G'b'G'b'F'b'F'b'F'b'M'b'G'b'M'b'M'b'M'b'F'b'F'b'M'b'B'
b'B'b'M'b'G'b'D'b'F'b'M'b'F'b'M'b'G'b'F'b'F'b'M'b'F'b'G'b'F'b'M'b'B'
b'B'b'F'b'F'b'M'b'F'b'G'b'G'b'F'b'F'b'F'b'M'b'F'b'G'b'F'b'D'b'M'b'B'
b'B'b'M'b'F'b'F'b'F'b'G'b'F'b'M'b'F'b'G'b'G'b'G'b'G'b'G'b'F'b'M'b'B'
b'B'b'M'b'M'b'M'b'F'b'M'b'F'b'F'b'F'b'M'b'G'b'W'b'W'b'G'b'G'b'M'b'B'
b'B'b'M'b'G'b'F'b'M'b'F'b'M'b'F'b'F'b'M'b'G'b'W'b'W'b'G'b'M'b'F'b'B'
b'B'b'M'b'G'b'F'b'F'b'G'b'M'b'M'b'G'b'G'b'G'b'W'b'W'b'G'b'M'b'G'b'B'
b'B'b'M'b'M'b'M'b'M'b'G'b'F'b'F'b'F'b'G'b'G'b'G'b'G'b'G'b'M'b'F'b'B'
b'B'b'B'b'B'b'B'b'B'b'B'b'B'b'B'b'B'b'B'b'B'b'B'b'B'b'B'b'B'b'B'b'B'
